"品名","OSAKA BASE","タナカ","ビックマックハウス","ライトオフ","All"
"TシャツL",0,0,220000,0,220000
"TシャツLL",0,0,275000,0,275000
"TシャツXL",0,0,220000,0,220000
"カジュアルシャツL",0,0,340000,0,340000
"カジュアルシャツLL",0,17000,374000,0,391000
"カジュアルシャツXL",0,0,408000,0,408000
"ポロシャツL",0,0,0,315000,315000
"ポロシャツLL",0,0,0,273000,273000
"ポロシャツM",270000,0,0,252000,522000
"ポロシャツS",225000,0,0,210000,435000
"ポロシャツXL",0,0,0,210000,210000
"All",495000,17000,1837000,1260000,3609000
